afterwards = потом
agenda = повестка дня
annual = годовой
apologize = извиняюсь
application = приложение
approach = подход
ascension = вознесение
attendance = посещаемость
attorney = адвокат
authorization = авторизации
awake = проснулся
back-up plans = резервные планы
banknote = банкноты
baptism = крещение
baptized = крещение
bearer = носителем
behalf = имени
betrayal = предательство
biannual = два раза в год
biased = предвзято
bidding = торги
bill = билл
billboard = афиша
borrow = взять
brand = бренд
bribe = взятки
budget = бюджет
capable of = способен
cashier = кассир
chew up = сжевать
clue = подсказка
co-worker = коллега
commission = комиссия
commodity = товар
concern = беспокойство
condensed = сгущенное
confirmation = подтверждение
consider = рассмотрим
consumer = потребителей
costs = расходы
crap = хрень
cruel = жестокий
cruising = крейсерская
crumble = покрошить
cuff me = наручники
currency = валюта
customer = клиент
cute = милые
debt = долг
decrease = снижение
defect = дефект
deficit = дефицит
delivery = доставка
demand = спрос
dependent = зависимые
deranged = невменяемый
disadvantage = недостаток
disguise = маскировка
dismiss = уволить
distracted = отвлекаться
distribution = распределение
divorce = развод
doubt = сомневаюсь
drunk-dialed = пьяный звонил
duty = обязанности
dye pack = пакет с краской
earning = зарабатывать
elucidate = разъяснить
embrace = объятия
employee = сотрудник
employer = работодателем
entrenching = шанцевый
equipment = оборудование
estimate = оценка
experience = опыт
facilities = зал
feedback = отзывы
feud = вражда
fiend = изверг
fire = огонь
fleeting = мимолетно
foul = правила
framed = оформлена
full-time = полный
gall = галл
goal = цель
gossip = сплетни
grieve = скорбим
growth = рост
grudge = злопамятность
guarantee = гарантия
gutter = водосток
haunting raugh = навязчивый крутые
hints = подсказки
hire = прокат
hired = нанял
hooker = проститутка
hourly = почасовая
improvement = улучшение
increase = увеличение
industry = промышленность
inflation = инфляция
insofar = если
inspired = вдохновение
interest = интерес
interview = интервью
inventory = инвентаризация
investigation = расследование
invoice = счет-фактура
it's nuts = это орехи
judge = судья
lats = латов
launch = запуск
laundered = отмываются
legacy = наследие
lend = лэнд
loan = кредит
lucrative = прибыльный
make redundant = делают излишним
market = рынок
marriage = брак
maternity leave = отпуск по беременности и родам
mention = упоминание
merger = слияние
mogul = могул
monthly = ежемесячно
nagging = нытье
naughty = шалить
nudge = тык
occupation = занятие
offer = предложение
order = заказ
ounce = унция
output = выход
overhelming = подавляющее
overtime = овертайм
parole = удо
part-time = часть времени
pay = платить
payment = оплата
penalty = штраф
petty cash = мелкие деньги
pity = жаль
plot thickens = интрига нарастает
product = продукт
profit = прибыль
promotion = продвижение
propose = предлагаю
public holidays = праздничные дни
purchase = купить
quarterly = ежеквартально
rapturous = восторженные
recipient = получатель
reckless = бесшабашные
recruit = набирать
refund = возврат
regimen = режим
rejected = отклонены
remuneration = вознаграждение
report = отчет
resign = в отставку
result = результат
retire = пенсию
reveal = раскрыть
rip off = сдирать
ripped = разорвал
rise = рост
risk = риск
salary = зарплата
scarcity = дефицит
scratch = нуля
screw you = винт вы
seemingly = казалось бы,
settled = поселились
shallow = мелкий
shaved = побрился
shed = сарай
shedule = расписание
sick leave = больничный
significant = значительное
sleuths = ищейки
slit = щелевая
slumming = нищебродами
spiraling = накручиваешь
stock = акции
strict = строгий
strike = удар
strugle = проблема
suffer = страдать
sullen = угрюмо
summoned = вызвали
supply = поставка
support = поддержка
suppose = предположим
survey = опрос
tapes = ленты
threat = угроза
tight = туго
tips = советы
trademark = товарный знак
trainee = стажер
underage = несовершеннолетних
unsocial hours = неудобные часы
vanity = тщеславие
verge = грани
vow = обет
wage = заработная плата
wedding = свадьба
weekly = еженедельно
whether = ли
wholesaler = оптовик
worker = работник
worthy = достойный
wound = раны
wrapped = завернутый
wrecking = вредительство
wrists = запястья
